'                                                                                                                                                                                                                                                    '
'                                                                                                                                                                                                                                                    '
'                                                                                                                                                                                                                                                    '
'                                                                                                                                                                                                                                                    '
'                                                                                                                                                                                                                                                    '
'                                                                                                                                                                                                                                                    '
'                                                                                                                                                                                                                                                    '
'                                                                                                                                                                                                                                                    '
'                                                                                                                                                                                                                                                    '
'                                                                                                                                                                                                                                                    '
'                                                                                                                                                                                                                                                    '
'                                                                                                                                                                                                                                                    '
'                                                                                                        oooooo    ooooooo                                                                                                                           '
'                                                                                                        XXXXXX    XXXXXXX                                                                                                                           '
'                                                                                                        XXXXXX    XXXXXXX                                                                                                                           '
'                                                                                         oooooooooooooooXXXXXX    XXXXXXX                                                ooo                                                                        '
'                                                oooooo                          ooo      XXXXXXXXXXXXXXXXXXXXX    XXXXXXX                                                XXX                                                                        '
'                                       ooo      XXXXXX                          xxx      XXXXXXXXXXXXXXXXXXXXX    XXXXXXX                                                XXX                                                                        '
'                                       xxx      XXXXXX      ooo                          XXXXXXXXXXXXXXXXXXXXX    XXXXXXX                                      ooo       XXX                 ooo                                                    '
'                                                XXXXXX      xxx        ooo               XXXXXXXXXXXXXXXXXXXXX    XXXXXXX                                      xxx       XXX                 xxx                                                    '
'                                ooo             XXXXXX                 xxx               XXXXXXXXXXXXXXXXXXXXX    XXXXXXX                                                XXX        ooo                ooo                                          '
'                        ooo     xxx             XXXXXX                                   XXXXXXXXXXXXXXXXXXXXX    XXXXXXX                              ooo               XXX        xxx                xxx                                          '
'                        xxx                     XXXXXX                                   XXXXXXXXXXXXXXXXXXXXX    XXXXXXX                              xxx               XXX                                                                        '
'                                                XXXXXX                                   XXXXXXXXXXXXXXXXXXXXX    XXXXXXX                                                XXX                                                                        '
'                                                XXXXXX                                   XXXXXXXXXXXXXXXXXXXXX    XXXXXXX                                                XXX                                                                        '
'        P              e                        XXXXXXXXXXXXXXXXXXXXXXXXXXXXXXXXXXXXXXXXXXXXXXXXXXXXXXXXXXXXXX    XXXXXXX                 e                              XXX             e                          e                 f             '
'XXXXXXXXXXXXXXXXXXXXXXXXXXXXXXXXXXXXXXXXXXXXXXXXXXXXXXXXXXXXXXXXXXXXXXXXXXXXXXXXXXXXXXXXXXXXXXXXXXXXXXXXXXXXXXXXXXXXXXXXXXXXXXXXXXXXXXXXXXXXXXXXXXXXXXXXXXXXXXXXXXXXXXXXXXXXXXXXXXXXXXXXXXXXXXXXXXXXXXXXXXXXXXXXXXXXXXXXXXXXXXXXXXXXXXXXXXXXXXXXXXXX'