'                                                           '
'                                                           '
'                                                           '
'                                                           '
'                                                           '
'                                                           '
'                                                           '
'                                                           '
'                                                           '
'                                                           '
'                                                           '
'                                                           '
'                                                           '
'                                                           '
'                                                           '
'                                                           '
'                                                           '
'                                                           '
'                                                           '
'                                                           '
'                                                           '
'                                                           '
'                                            xxx            '
'                                      xxx                  '
'                                xxx                        '
'          P     ooooooooooooo                              '
'XXXXXXXXXXXXXXXXXXXXXXXXXXXXXXXXXXXXXXXXXXXXXXXXXXXXXXXXXXX'